"filename", "language", "HTML", "PHP", "Markdown", "JavaScript", "comment", "blank", "total"
"c:\Users\29032\Desktop\daershang\database\README.md", "Markdown", 0, 0, 1, 0, 0, 1, 2
"c:\Users\29032\Desktop\daershang\database\ajax.js", "JavaScript", 0, 0, 0, 80, 1, 9, 90
"c:\Users\29032\Desktop\daershang\database\count\rank.php", "PHP", 0, 25, 0, 0, 5, 7, 37
"c:\Users\29032\Desktop\daershang\database\count\show.php", "PHP", 0, 27, 0, 0, 5, 7, 39
"c:\Users\29032\Desktop\daershang\database\course\delete.php", "PHP", 0, 19, 0, 0, 0, 1, 20
"c:\Users\29032\Desktop\daershang\database\course\insert.php", "PHP", 0, 22, 0, 0, 0, 4, 26
"c:\Users\29032\Desktop\daershang\database\course\show.php", "PHP", 0, 22, 0, 0, 5, 7, 34
"c:\Users\29032\Desktop\daershang\database\course\update.php", "PHP", 0, 19, 0, 0, 0, 3, 22
"c:\Users\29032\Desktop\daershang\database\course\update1.php", "PHP", 0, 22, 0, 0, 0, 3, 25
"c:\Users\29032\Desktop\daershang\database\grade\delete_grade.php", "PHP", 0, 20, 0, 0, 0, 1, 21
"c:\Users\29032\Desktop\daershang\database\grade\insert.php", "PHP", 0, 21, 0, 0, 0, 3, 24
"c:\Users\29032\Desktop\daershang\database\grade\search.php", "PHP", 0, 23, 0, 0, 5, 6, 34
"c:\Users\29032\Desktop\daershang\database\grade\show.php", "PHP", 0, 22, 0, 0, 5, 7, 34
"c:\Users\29032\Desktop\daershang\database\grade\update_grade.php", "PHP", 0, 20, 0, 0, 0, 3, 23
"c:\Users\29032\Desktop\daershang\database\grade\update_grade1.php", "PHP", 0, 21, 0, 0, 0, 3, 24
"c:\Users\29032\Desktop\daershang\database\login.html", "HTML", 97, 0, 0, 0, 0, 10, 107
"c:\Users\29032\Desktop\daershang\database\login\login.php", "PHP", 0, 41, 0, 0, 13, 11, 65
"c:\Users\29032\Desktop\daershang\database\paging.php", "PHP", 0, 38, 0, 0, 1, 3, 42
"c:\Users\29032\Desktop\daershang\database\register.html", "HTML", 108, 0, 0, 0, 1, 10, 119
"c:\Users\29032\Desktop\daershang\database\register\register.php", "PHP", 0, 57, 0, 0, 9, 13, 79
"c:\Users\29032\Desktop\daershang\database\selection\show.php", "PHP", 0, 25, 0, 0, 5, 6, 36
"c:\Users\29032\Desktop\daershang\database\show.html", "HTML", 289, 0, 0, 0, 0, 13, 302
"c:\Users\29032\Desktop\daershang\database\show2.html", "HTML", 253, 0, 0, 0, 0, 10, 263
"c:\Users\29032\Desktop\daershang\database\show3.html", "HTML", 244, 0, 0, 0, 0, 10, 254
"c:\Users\29032\Desktop\daershang\database\show4.html", "HTML", 136, 0, 0, 0, 0, 4, 140
"c:\Users\29032\Desktop\daershang\database\show5.html", "HTML", 141, 0, 0, 0, 0, 4, 145
"c:\Users\29032\Desktop\daershang\database\show6.html", "HTML", 175, 0, 0, 0, 0, 8, 183
"c:\Users\29032\Desktop\daershang\database\student\delete.php", "PHP", 0, 19, 0, 0, 0, 1, 20
"c:\Users\29032\Desktop\daershang\database\student\insert.php", "PHP", 0, 23, 0, 0, 0, 4, 27
"c:\Users\29032\Desktop\daershang\database\student\show.php", "PHP", 0, 22, 0, 0, 5, 7, 34
"c:\Users\29032\Desktop\daershang\database\student\update.php", "PHP", 0, 19, 0, 0, 0, 3, 22
"c:\Users\29032\Desktop\daershang\database\student\update1.php", "PHP", 0, 23, 0, 0, 0, 3, 26
"Total", "-", 1443, 550, 1, 80, 60, 185, 2319